



							#################

                                 ##########

##################################################
##################################################
##################################################